488888888888888884
811111111111111118
812070000030000718
811111111111111118
488888888888888884